;width
26
;height
8
;board
##########################
# .......................#
#..#...#..######..#####..#
#..#...#..#    #..#..o...#
#o.#...#.o#    #..#......#
#..#####..######..#####..#
#........................#
##########################
;pacman
1,1,RIGHT,NORMAL
;ghosts
blinky,6,1,LEFT,CHASE
inky,1,5,UP,CHASE
pinky,1,6,DOWN,CHASE
clyde,2,6,RIGHT,SCATTER